NO ./img/path_to_the_north_texture.xpm
SO ./img/path_to_the_south_texture.xpm
WE ./img/path_to_the_west_texture.xpm
EA ./img/path_to_the_east_texture.xpm
DO ./img/door.xpm

F 0,0,51
C 0,51,0
        1111111111111111111111111
        1000000000110000000000001
        1011000001110000010000001
        10010000000D000010N000101
111111111011000001110000000001001
100000000011000001110111111111111
11110111111111011100000010001
11110111111111011101010010001
11000000110101011100000010001
10000000000000001100000001001
10000000000000001101010010001
11000001110101011111001110001
11110111 1110101 101111010001
11111111 1111111 111111111111