SO ./img/path_to_the_south_texture.xpm
EA ./img/path_to_the_east_tasdawawugaowbaoiwbfexture.xpm
SO ./img/path_to_the_south_texture.xpm
F      0,0,255
EA ./img/path_to_the_east_texture.xpm
DO ./img/door.xpm
EA ./img/path_to_the_east_texture.xpm
WE 					./img/path_to_the_west_texture.xpm



NO ./img/path_to_the_north_texture.xpm
EA ./img/path_to_the_south_texture.xpm

C 225,30,0,

        1111111111111111111111111
        1000000000110000000000001
        1011000001110000001000001
        100101110000000001E000001
11111111101101 100111000000000001
100000000011011101110111111111111
11110111111111011100000010001
11110111111111011101010010001   111
11000000110101011100000010001   101
11111111111111111111111111111   111
 
11111111111111111111111111111
10000000000000001100000001001
10000000000000001101010010001
11000001110101011111001110001
11110111 1110101 101111010001
11111111 1111111 111111111111
        1111111111111111111111111
        1000000000110000000000001
        1011000001110000001000001
        1001011100000000010000001
11111111101101 100111000000000001
100000000011011101110111111111111
11110111111111011100000010001
11110111111111011101010010001   111
11000000110101011100000010001   101
11111111111111111111111111111   111
 
11111111111111111111111111111
10000000000000001100000001001
10000000000000001101010010001
11000001110101011111001110001
11110111 1110101 101111010001
11111111 1111111 111111111111
        1111111111111111111111111
        1000000000110000000000001
        1011000001110000001000001
        1001011100000000010000001
11111111101101 100111000000000001
100000000011011101110111111111111
11110111111111011100000010001
11110111111111011101010010001   111
11000000110101011100000010001   101
11111111111111111111111111111   111
 
11111111111111111111111111111
10000000000000001100000001001
10000000000000001101010010001
11000001110101011111001110001
11110111 1110101 101111010001
11111111 1111111 111111111111
        1111111111111111111111111
        1000000000110000000000001
        1011000001110000001000001
        1001011100000000010000001
11111111101101 100111000000000001
100000000011011101110111111111111
11110111111111011100000010001
11110111111111011101010010001   111
11000000110101011100000010001   101
11111111111111111111111111111   111
 
11111111111111111111111111111
10000000000000001100000001001
10000000000000001101010010001
11000001110101011111001110001
11110111 1110101 101111010001
11111111 1111111 111111111111
        1111111111111111111111111
        1000000000110000000000001
        1011000001110000001000001
        1001011100000000010000001
11111111101101 100111000000000001
100000000011011101110111111111111
11110111111111011100000010001
11110111111111011101010010001   111
11000000110101011100000010001   101
11111111111111111111111111111   111
 
11111111111111111111111111111
10000000000000001100000001001
10000000000000001101010010001
11000001110101011111001110001
11110111 1110101 101111010001
11111111 1111111 111111111111
        1111111111111111111111111
        1000000000110000000000001
        1011000001110000001000001
        1001011100000000010000001
11111111101101 100111000000000001
100000000011011101110111111111111
11110111111111011100000010001
11110111111111011101010010001   111
11000000110101011100000010001   101
11111111111111111111111111111   111
 
11111111111111111111111111111
10000000000000001100000001001
10000000000000001101010010001
11000001110101011111001110001
11110111 1110101 101111010001
11111111 1111111 111111111111
        1111111111111111111111111
        1000000000110000000000001
        1011000001110000001000001
        1001011100000000010000001
11111111101101 100111000000000001
100000000011011101110111111111111
11110111111111011100000010001
11110111111111011101010010001   111
11000000110101011100000010001   101
11111111111111111111111111111   111
 
11111111111111111111111111111
10000000000000001100000001001
10000000000000001101010010001
11000001110101011111001110001
11110111 1110101 101111010001
11111111 1111111 111111111111
        1111111111111111111111111
        1000000000110000000000001
        1011000001110000001000001
        1001011100000000010000001
11111111101101 100111000000000001
100000000011011101110111111111111
11110111111111011100000010001
11110111111111011101010010001   111
11000000110101011100000010001   101
11111111111111111111111111111   111
 
11111111111111111111111111111
10000000000000001100000001001
10000000000000001101010010001
11000001110101011111001110001
11110111 1110101 101111010001
11111111 1111111 111111111111
