NO ./img/path_to_the_north_texture.xpm
SO ./img/path_to_the_south_texture.xpm
WE ./img/path_to_the_west_texture.xpm
EA ./img/path_to_the_east_texture.xpm
F 98,105,109
C 80,130,200

    1111111111111111111111111
   110000000000000000000011
  11000000000000010000000011
 11000000000000000000000011
11000000000000000000000011
 11000000000010000000000011
  11000000000000000000000011
   11000000000000000000000011
  11000000000000000000000011
 110000000000N0000000000011
11111111111111111111111111